Match Link
111441085
111444021
111446130
111446126
111450306
111457457
111467344
111468432
111538302
111540648
111540803
111541661
111544882
111547397
111554347
111559364
111562241
111566094
111567908
