Match Link
118985801
118993065
118996071
118977476
118998749
118993107
118975810
118999921
118996070
118984930
118996524
118997012
118999927
118996523
118987965
118986770
118968018
118996522
118987896
118990806
118990180
118975814
118990182
118986768
118994905
118990156
118999418
119000738
118982141
118989016
118997577
118994278
118992316
118987895
118989008
118995209
118998149
118998752
