Match Link
119189782
119193247
119193319
119193331
119193826
119194471
119195075
119196396
119197442
119200907
119201307
119202981
119203226
119204968
119206077
119207311