Match Link
119122293
119125026
119126621
119127162
119128465
119131071
119134317
119137054
119137434
119137444
119138207
119139083
119139084
119139088
119139766
119140299